+---+---+---+---+
|               |
+   +       +---+
|   |       |   |
+   +---+   +   +
|               |
+   +---+   +---+
|       |       |
+---+---+---+---+