+---+---+---+---+
|               |
+   +---+   +---+
|   |           |
+   +   +---+---+
|               |
+   +---+   +---+
|               |
+---+---+---+---+