+---+---+---+---+
|               |
+   +       +---+
|   |           |
+   +   +---+---+
|               |
+   +---+   +---+
|               |
+---+---+---+---+