+---+---+---+---+
|       |       |
+   +   +   +---+
|   |           |
+   +       +   +
|           |   |
+   +---+   +---+
|       |       |
+---+---+---+---+